11111111111111111111111111111111
13311311133311122222222212222221
13332332223333111121111133332211
12355555115555555555555123332211
12356445115444444444445233233221
12254445335455555555545555133221
12355545215451223331544445133221
13222545555455555231545555133221
13222544444444465232545333233221
12255545555545545232545333222221
11154445222545545555545522222221
11155545222544444444444511222211
13323545555545555555554511233311
13323544645545222223354513311111
11333545545545333333354513311121
11323545544445333333356523331221
11112545555545233333254522231221
11555545222545222222254522332221
11544445555545555555554512331221
13555544444444444444444512331211
13333545555545555455555522331211
12332545311545225452222222332211
12332545222545225452211112332221
12331545113545225452213333332211
12331545555545225452233333322211
12355544344445335453333333223321
12354445555545335453233333323321
12355545222545335453233212223221
11113545555545135553233122223221
11222544444445133333333122233221
13222555555555333331112211222221
11111111111111111111111111111111
